C C C C C C C C C C C C C C C C C C C C C C C C C C C C C C C C C C C C C C C C C
C B B B B B B B B B B B C B C B B B B B B B B B B B B B B B B B B B B B B B C B B
C C B C C C C C B C C C C B C B C C C C C C C C C C C C C C C C C C C C C B C C C
B C B B B B B C B C B B R B C B C B B B B B B B B B B B B B B B B B B B C B C C C
C C B C C C C C B C C B R C C B C C C B C C C B B B C C C C C C C C C C C B C C C
C B B C B B B B B B C B R B B C C B C C C B C C C B C B B B B B B B B B B B C C C
C C B C C C C C C C C W R B C C B B B B B B B B C B C C C C R R R C C C C B C C C
B C B B B B B B B B B B B B C C C C C C C C C C C B C C C C R R R C C C C B C C C
C C B B C C C C C C C C C C C C B B B B C B B B C B W W W C B B B C C C C B C C C
C B B B C B B B B B B B B B B B B C C C C C C B B B C C C C B C B C C C C B C C C
C C C B C B C C C C C C C C C C C C B B B B C C C B C C W W B B B C C C C B C C C
C B C B C B C B B B B B B B B B B B B C C B C B C C B C C C C C C C C C C B C C C
C C C B C B C B C C C C C C C C C C C C C B C B C C C B C C C C C C C C C B C C C
B B C C C B C B C B C C C C C C C C C C C B C B C C C C B C C C C C C C C B C C C
B B B B B C C B C B C C C C C C C C C C C B C B C C C C C B C C C C C C C B C C C
C C C C C C B B C B C B B B C C B B C C C B C C C B C C C C B C C C C C C B C C C
C B B C C B C C C B C B C C C C B C B C C B B B B B B B B C C B C C C C C B C C C
C B C C B C C B B B C B B B C C B B C C C C C C C C C C C C C B C C C C C B C C C
C C C B C C B C C C C C C B C C B C B C C C C C C C C C C C C B C C C C C C C C C
C C B C C B C C C C C B B B C C B B C C C C C C C C C C B B B B B B B B B B B B B
C B C C B C C C C C C C C C C C C C C C C C C C C C C C C C C C C C C C C C C C C
C C C B C C C C C C C C C C C C C C C C C C C C C C C C C C C C C C C C C C C C C
B B B B C B B B B B B B B B B B B B B B B B B B B B B B B B B B B B B B B B B B C
C C C C C C C C C C C C C C C C C C C C C C C C C C C C C C C C C C C C C C C C C
C C C C C C C C C C C C C C C C C C C C C C C C C C C C C C C C C C C C C C C C C
C C C C C C C C C C C C C C C C C C C C C C C C C C C C C C C C C C C C C C C C C
C C C C C C C C C C C C C C C C C C C C C C C C C C C C C C C C C C C C C C C C C
C C C C C C C C C C C C C C C C C C C C C C C C C C C C C C C C C C C C C C C B C
C C C C C C C C C C C C C C C C C C C C C C C C C C C C C C C C C C C C C B B B C
C C C C C C C C C C C C C C C C C C C C C C C C C C C C C C C C C C C B B C C C B
