40 1 1 0
30 1 1 0
20 1 1 0
50 1 1 0
10 1 1 0